BBBBBBBBBBBBBBBBBBBBBBBBBBBBBBBBBBBBBBBB
BP-----R--------------------R--------R-B
B-----R--------------R----------D------B
B--------R--R--D-----------------------B
BR-------------------------------------B
B-------------------R------------------B
B-R---------------------R---------R----B
B--R-----R-----------R--R-------------RB
B------R------R---------D-----------R--B
B-------****--R-*D**----****----****---B
B--D----****--R-****----****----****R--B
B--------------------------------------B
B---R------------------------------R---B
B---R-----R---------------D------------B
B------R-----------R------------R-----RB
B-----------R-------R-------------D----B
B--R--------------R-------R------------B
B-------D-------------R---------R------B
B--------------------------------R--R--B
B----R------R-RR------------------R----B
BE----------R-RR---------R--R-R--------B
BBBBBBBBBBBBBBBBBBBBBBBBBBBBBBBBBBBBBBBB
