BBBBBBBBBBBBBBBBBBBBBBBBBBBBBBBBBBBBBBBB
B------ --D-R -----R-R------- ----R----B
B-RPR------ ---------RD--R---- ----- --B
B---------- --R-----R-R--R--------R----B
BR-RR---------R------R--R----R---R-----B
BR- R--------- R--R--------R------R-RR-B
B--- --R--------R-----R- R--------R-RR-B
BBBBBBBBBBBBBBBBBBBBBBBBBBBBBBB---R--R-B
B- ---R--D- --R-R----------D-RD------ -B
B--D-----R----- --------RR R--R----R---B
B---R--R-R--------------R -R--R--------B
B-R-----R--------RRR-------R-- -D----R-B
B-D-- --R-  -----R-RD--D----R---R--D- -B
B- R--------------R R--R--------D-----RB
B--------BBBBBBBBBBBBBBBBBBBBBBBBBBBBBBB
B R---------R---D----R-----R---R-------B
B R--------- R--R--------R------R-RR--EB
B- --R--------R-----R-  ----D---R-RR---B
B----RD--R--------R------R-RD------R---B
B--- --R- --R-RR---------R-RD------ --RB
B-D---- ----- --------- -R--R----R---R-B
BBBBBBBBBBBBBBBBBBBBBBBBBBBBBBBBBBBBBBBB
