BBBBBBBBBBBBBBBBBBBBBBBBBBBBBBBBBBBBBBBB
BP-------------------------------------B
B--------------------------R-----------B
B--------------------------------------B
B---------R----------R-----------------B
B--------------------------------------B
B--------------------------------------B
B---R-----------R----------R-----------B
B-------  -----  -----  -----  --------B
B---R---   -----   -----   -----   ----B
B------- D ----- D ----- D ----- D ----B
B--------------------------------------B
B---R------R---------R------R----------B
B--------------R-----------------------B
B-------  -----  -----  --R--  --------B
B---R---   -----   -----   -----   ----B
B------- D ----- D ----- D ----- D ----B
B--------------------------------------B
B-------------R----------R-------------B
B--------------------------------------B
B-------------------------------E------B
BBBBBBBBBBBBBBBBBBBBBBBBBBBBBBBBBBBBBBBB
BBBBBBBBBBBBBBBBBBBBBBBBBBBBBBBBBBBBBBBB
BP-------------------------------------B
B--------------------------R-----------B
B--------------------------------------B
B---------R----------R-----------------B
B--------------------------------------B
B--------------------------------------B
B---R-----------R----------R-----------B
B-------**-----**-----**-----**--------B
B---R---***-----***-----***-----***----B
B-------*D*-----*D*-----*D*-----*D*----B
B--------------------------------------B
B---R------R---------R------R----------B
B--------------R-----------------------B
B-------**-----**-----**--R--**--------B
B---R---***-----***-----***-----***----B
B-------*D*-----*D*-----*D*-----*D*----B
B--------------------------------------B
B-------------R----------R-------------B
B--------------------------------------B
B-------------------------------E------B
BBBBBBBBBBBBBBBBBBBBBBBBBBBBBBBBBBBBBBBB
